-18
18
-11
10
1111111111111111111111111111111111111
1111111111111111111111111111111111111
1000000000000000000000000000000000011
1000000000000000000000000000000000011
1000000000000000000000000000000000011
1000000000000000000000000011111000011
1000010000100000000000000011111000011
1000010000100001000000000011111000011
1000011111100000000000000011111000011
1000011111100100000000000000000000011
1000000000000000000000000000000000011
1000000000000000000000000000000000011
1000000000000000000000000000000000011
1000000000000010000000000000000000011
1000000100000000000000001000000000011
1000000000001000000000000000000000011
1000000000001000000000000000000000011
1000000000000000000000000000000000011
1000000000000000000000000000000000011
1000000000000000000000000000000000011
1000000000000000000000000000000000011
1111111111111111111111111111111111111
