-13
13
-6
6
000000000000000000000000000
000000000000000000000111110
100001000000000000000111110
100001000010000000000111110
111111000000000000000111110
111111001000000000000000000
000000000000000000000000000
000000000000000000000000000
000000000000000000000000000
000000000100000000000000000
001000000000000000010000000
000000010000000000000000000
000000010000000000000000000
